This readme.txt describes the contents of the envidata\can_tm directory
on the ENVI Resource DVD. The data files cover a site near Canon 
City, Colorado, USA.


can_tmr.img	Canon City TM Data
can_tmr.hdr	ENVI header for above
can_km.img	K-means classification
can_km.hdr	ENVI header for above
can_iso.img	ISODATA classification
can_iso.hdr	ENVI header for above
classes.roi	Regions of interest (ROI) for supervised classification
can_pcls.img	Paralleleliped classification
can_pcls.hdr	ENVI header for above
can_bin.img	Binary Encoding result
can_bin.hdr	ENVI header for above
can_sam.img	Spectral Angle Mapper (SAM) classification result
can_sam.hdr	ENVI header for above
can_rul.img	Rule image for SAM classification
can_rul.hdr	ENVI header for above
can_sv.img	Sieved image
can_sv.hdr	ENVI header for above
can_clmp.img	Clump of sieved image
can_clmp.hdr	ENVI header for above
can_comb.img	Combined classes image
can_comb.hdr	ENVI header for above
can_ovr.img	Classes overlain on grayscale image
can_ovr.hdr	ENVI header for above
can_v1.evf	Vector layer generated from class #1
can_v2.evf	Vector layer generated from class #2
can_v3.evf	Vector layer generated from class #3
can_v4.evf	Vector layer generated from class #4
can_lst.evf	List of EVF files (for automated opening)
can_tm1.roi	Canon City TM ROI #1
can_tm2.roi	Canon City TM ROI #2